"filename", "language", "x86-x64 Assembly", "Batch", "comment", "blank", "total"
"c:\tictactoe\assemble.bat", "Batch", 0, -11, 0, -5, -16
"c:\tictactoe\clearConsole.asm", "x86-x64 Assembly", -16, 0, -2, -8, -26
"c:\tictactoe\fetchUserInput.asm", "x86-x64 Assembly", -49, 0, -3, -11, -63
"c:\tictactoe\main.asm", "x86-x64 Assembly", -31, 0, -2, -8, -41
"c:\tictactoe\printBoard.asm", "x86-x64 Assembly", -62, 0, -4, -22, -88
"e:\vs_studio\ASM-tictactoe\assemble.bat", "Batch", 0, 11, 0, 5, 16
"e:\vs_studio\ASM-tictactoe\clearConsole.asm", "x86-x64 Assembly", 16, 0, 2, 8, 26
"e:\vs_studio\ASM-tictactoe\fetchUserInput.asm", "x86-x64 Assembly", 70, 0, 3, 12, 85
"e:\vs_studio\ASM-tictactoe\gameLoop.asm", "x86-x64 Assembly", 30, 0, 2, 22, 54
"e:\vs_studio\ASM-tictactoe\main.asm", "x86-x64 Assembly", 28, 0, 2, 8, 38
"e:\vs_studio\ASM-tictactoe\printBoard.asm", "x86-x64 Assembly", 62, 0, 5, 22, 89
"Total", "-", 48, 0, 3, 23, 74